gm,game_date,result,r,ra,run_diff
15,2025-04-11,W,3,0,3
14,2025-04-09,W,6,5,1
13,2025-04-08,L,2,8,-6
12,2025-04-07,L,4,6,-2
11,2025-04-06,L,7,8,-1
10,2025-04-05,W,3,1,2
9,2025-04-04,L,2,3,-1
8,2025-04-02,W,6,5,1
7,2025-04-01,W,3,1,2
6,2025-03-31,W,6,1,5
5,2025-03-29,W,7,3,4
4,2025-03-28,W,8,5,3
3,2025-03-27,W,5,4,1
2,2025-03-19,W,6,3,3
1,2025-03-18,W,4,1,3
